      

    NO           ./path_to_the_north_texture

SO ./path_to_the_south_texture
WE ./path_to_the_west_texture
EA ./path_to_the_east_texture




F 220,100,0
C 225,30,0

        1111111111111111111111111
        1000000000000000000000001
        10110000011100000000000011111
        100100000011111110000000000011
1111111110110000011    110000000000001
10000000001100000111111111111111111111
11110111111111011100000000001
11110111111111011101010010001
11000000110101011100000010001
10000000000000001100000010001
10000000000000000001010010001
11000001110101011111011110N0111
11110111 1110101 101111010001
11111111 1111111 111111111111